WWWWWWWWWW
W-G-WWGT-W
W--WWWW--W
WW-W-GW--W
WW-W---W-W
W----W---W
W----W-TTW
W---WW---W
WS--WWGTEW
WWWWWWWWWW