WWWWWWWWWWWW
W----------W
W-WWWWWWWW-W
W-W--------W
W-W-WWWWWWWW
W-W--------W
W-WWWWWWWW-W
WSTE-------W
WWWWWWWWWWWW