WWWWWWW
W-S-E-W
W-----W
WG--T-W
W--T--W
W-T-G-W
W--T--W
W-G-T-W
W--T--W
W-T-G-W
W--T--W
W-G-T-W
WWWWWWW