WWWWWWWWWW
W--------W
W---SE---W
W--------W
WWWWWWWWWW