WWWWWWWWWWW
WG----WGGGW
W--WT--WGGW
W-SWWT--WTW
W-WWWWT-TTW
W--WWT---TW
WG----W--EW
WWWWWWWWWWW